0	0	0	0	0	0	0	0	0	0	0	0	0	0	0	0	0	0	0	0	0	0	0	0	0	0	0	0	0	0	0	0
0	1	1	0	2	2	2	2	2	2	2	2	2	2	2	2	2	2	2	2	2	8	8	8	2	2	2	2	2	2	2	0
0	1	1	1	8	2	2	2	8	2	2	8	8	8	2	2	2	2	2	2	2	8	2	8	2	2	2	2	2	2	2	0
0	0	0	0	8	2	8	2	2	2	2	8	2	8	8	8	8	8	2	8	8	8	2	8	2	0	0	0	0	0	0	0
0	2	2	2	8	2	2	2	2	2	8	8	2	2	8	2	2	8	2	8	2	8	2	8	8	0	3	3	3	3	3	0
0	2	2	8	8	2	2	8	2	2	8	2	2	2	8	2	2	8	8	8	2	8	8	2	8	1	10	1	1	2	2	0
0	2	2	8	2	2	2	8	2	2	8	2	2	2	2	2	2	2	2	2	2	2	2	2	2	0	3	2	1	1	1	0
0	2	2	8	2	8	8	8	2	8	8	2	2	2	2	3	3	3	3	3	3	3	3	3	3	3	3	2	1	7	1	0
0	2	2	8	2	8	2	8	2	8	2	2	2	2	2	3	2	8	2	2	2	2	2	8	2	0	3	2	1	1	1	0
0	2	2	8	8	8	2	8	2	8	2	2	2	8	2	3	2	2	2	2	2	2	2	2	2	0	3	2	2	2	2	0
0	2	2	2	2	2	2	8	2	8	2	2	2	2	2	3	8	2	2	2	2	2	2	2	2	0	3	3	3	3	3	0
0	2	2	8	2	2	2	8	2	8	2	2	2	2	2	3	2	2	2	2	2	8	2	2	2	0	0	0	0	0	0	0
0	2	2	2	2	2	2	8	8	8	2	2	2	2	2	3	2	2	2	2	2	2	2	2	8	2	8	2	8	2	2	0
0	0	0	0	0	0	8	8	2	2	2	2	2	8	2	3	2	2	8	2	2	2	2	2	2	2	2	2	2	2	2	0
0	8	8	8	2	0	8	8	2	8	2	2	2	2	2	3	2	2	2	2	2	8	2	2	2	1	1	1	2	2	2	0
0	8	2	8	8	8	8	8	2	2	1	1	1	1	1	11	1	1	1	1	1	1	1	1	1	1	6	1	2	2	2	0
0	8	2	2	2	0	2	2	2	2	1	8	2	2	2	3	2	2	1	8	2	2	2	2	8	1	1	1	2	2	2	0
0	8	8	8	2	0	2	2	2	2	1	2	2	2	2	3	2	2	1	2	8	2	2	8	2	2	2	2	2	8	2	0
0	0	0	0	0	0	2	3	3	3	10	3	3	3	3	3	8	2	8	2	2	2	8	2	8	2	2	2	2	2	2	0
0	2	2	2	8	2	2	3	2	8	1	2	2	2	2	2	2	2	2	8	2	2	2	2	2	2	2	2	2	2	2	0
0	2	2	2	2	2	2	3	2	2	1	2	2	2	2	2	2	8	2	2	8	8	2	2	2	2	2	2	2	2	2	0
0	2	2	8	2	1	1	10	1	1	1	2	2	2	2	2	2	2	8	2	2	1	1	1	1	9	2	8	2	2	2	0
0	2	2	2	2	1	2	3	2	2	8	8	2	8	2	2	2	8	2	2	2	1	2	2	8	2	2	2	2	2	2	0
0	2	8	2	2	1	2	3	2	2	2	2	2	2	2	2	2	2	2	2	2	1	2	2	2	2	2	2	2	2	2	0
0	2	2	2	2	1	2	3	2	1	1	1	1	1	1	1	1	1	1	1	1	1	1	1	1	2	2	2	8	2	2	0
0	2	2	8	2	1	2	3	2	1	2	2	2	2	2	2	2	2	2	2	2	2	2	2	1	2	2	2	2	2	2	0
0	2	2	2	2	1	2	3	2	1	2	2	2	2	2	1	1	1	1	1	1	1	1	1	1	1	1	1	1	2	2	0
0	3	3	3	3	10	3	3	2	1	2	8	2	2	2	1	2	2	2	2	2	1	2	2	2	2	2	2	1	2	2	0
0	2	2	2	2	1	2	8	2	1	2	2	2	2	2	1	2	2	2	2	2	1	8	2	2	2	2	2	1	5	2	0
0	2	2	2	8	1	1	1	1	1	1	8	2	2	2	1	2	2	2	2	2	2	2	2	2	2	2	2	2	2	2	0
0	2	2	2	2	2	2	2	2	2	2	2	2	0	0	1	1	0	0	2	2	2	2	2	2	2	2	2	2	2	2	0
0	0	0	0	0	0	0	0	0	0	0	0	0	1	1	1	1	0	0	0	0	0	0	0	0	0	0	0	0	0	0	0